#########
#O   PO##
#   X# ##
# #  XO #
#    X# #
#####   #
#########
