########
#      #
# #X   #
# X P#O#
##X#O  #
##    O#
########
