########
####P ##
###  OO#
## X#X##
#   XO #
#  #   #
#    ###
########
